000000000000000000000000000
055552222222222555522222250
057677774444427777757777850
027777764444772777757777750
027777774477777277775777750
022222222277777772777777750
022255522277757772777777720
052255522277777777277376720
052255522277777727772377720
022233332277767772333377750
027777277777777777555577750
027777777777767777777576750
023333333377777773333533350
027777777677777777577777750
024444447777777777577577750
024444447777222777575577750
024644447777212777777577750
055555555555555555555555550
000000000000000000000000000